11111111111111111111111111111111
1P00000000CCCCCCCCC0000000000001
10000000000000000000000000000001
10011001100110011001100110011001
10011001100110011001100110011001
10000000000000000000000000000001
10000000000000000000000000000001
10011001100110011001100110011001
10011001100110011001100110011001
10000000000000000000000000000001
100000000000000000000000CCCCC001
10011001100110011001100110011001
10011001100110011001100110011001
100CCCCCCCC000000000000000000001
100000000000000000000000000000E1
11111111111111111111111111111111