1111111111111111
10P0001111101111
1001100C00100101
10C110CC1CCCCE01
10CCCCC010000001
1000000001000001
1111111111111111