1111111111111111
10P0001111101111
1000000C00100001
10C110CCCCCCC0E1
10CCCCC010000001
1111111111111111