111111111111111111111111111111111111111111111111111111111
1C001000010100E000000100000000000000000000000000000000001
111001110011111000011010000000000000000000000000000000001
110100P01010111100100010000000000000000000000000000000001
110011001000100001000011000000000000000000000000000000001
11000010111110011110001C000000000000000000000000000000001
110000100000001000000011000000000000000000000011000000001
110000010011000000000010000000000000000000000000000000001
111111111111111111111000000000000000000000000000000000001
111111111111111111111100000000000000000000000000000000001
111111111111111111111111111111111111111110111111111111111
111111111111111111111111111111111111111110111111111111111
1C0010000101000000000100000000000000000000000000000000001
111001110011111000011010000000000000000000000000000000001
110100001010111100100010000000000000000000000000000000001
110011001000100001000011000000000000000000000000000000001
11000010111110011110001C000000000000000000000000000000001
110000100000001000000011000000000000000000000011000000001
110000010011000000000010000000000000000000000000000000001
111111111111111111111000000000000000000000000000000000001
111111111111111111111100000000000000000000000000000000001
111111111111111111111111111111111111111111111111111111111