1111111111111111111111111111111
1P00000001000001C00000001001CC1
1001001001111001111111001001001
1001001000000000000000000001001
1001001111111111111001111111001
1001001001CC1001001001001001001
1001001001001CC1001001001001001
1001000001001000000000001000001
1001111001001001111001001111001
10000C10000010000E1001000000001
1111111111111111111111111111111