111111111111111111111
10000010000P000000001
1E0100000000000000001
100100000000000000001
100000100000000000101
100000000010000000001
111111111111111111111
111111111111111111111
111111111111111111111
111111111111111111111
