11111111111111111111111
1C00100001001E000000001
11100111001000000001111
110100P0101011110010001
11001100100010000100001
11000010111110111110001
11000010000000100000001
11000001001100100000001
11111111111111111111111
