1111111111111111111111
10C1E00010010000000011
1100111001101000000011
1010000100000P00000011
1111111111111111111111
1111111111111111111111
