111111111111111111111
10000010000P000000001
1E010E000000000000001
10C100000000CC0000001
100000100000C00000101
1C0000000010000000001
111111111111111111111
111111111111111111111
111111111111111111111
111111111111111111111
00
1
